1111111111111
10V10000000C1
1000011111001
1P0011E00V001
1111111111111
